Raster:
72
150
000000000000000000000000000000000000000000000000000111100000000000000000000000000000000000000000000000000000000000000000000000000000000000000000000000
000000000000000000000000000000000000000000000000011111100000000000000000000000000000000000000000000000000000000000000000000000000000000000000000000000
000000000000000000000000000000000001111111110111111111110000000000000000000000000000000000000000000000000000000000000000000000000000000000000000000000
000000000000000000000000000000011111111111111111111111111000000000000000000000000000000000000000000000000000000000000000000000000000000000000000000000
000000000000000000000000000000001110001111011111111111111100000000000000000000000000000000000011110000000000011110000000000000000000000000000000000000
000000000000000000000000000010000100111000011111111111111110000000000000000000000000000000000111000000000111110111110000000000000000000000000000000000
000000000000000000000000000001000000111000000001111111111100000000000000000000000000000000011100000000011111111111000000000000000000000000000000000000
000000000000000000000000000000100001111000000001111111111110000000000000000000000000000000011000000000001111111111111111110000000000000000000000000000
000000000000000000000000000000000000000000000000111111111111000000000000000000000000000000111000011011111111111111111111111000001111100000000000000000
000000000000000000001100000000001000000000000000011111111111000000000000000000011000000000000000011011111111111111111111111111111111111100000000000000
000000000000000000011101101000101011110000000000011111111100000000000000000011111111000000000110011011111111111111111111111111111111111111111111000000
000000000000000000000011111100000001111100000000011111111000000000000000000111111101100001111111111111111111111111111111111111111111111111111111111100
001111111111100000000000111110000000111111000000111111110000000000000000001111011100001111111111111111111111111111111111111111111111111111111111111000
001111111111111111111110000000001100100001100000111111100000000000000000011110011110011111111111111111111111111111111111111111111111111111111111000000
000111111111111111111111111111111110000001111000011111000000000000000001111100111111111111111111111111111111111111111111111111111111111111111100000000
001111111111111111111111111111111110000001110000001111000000000000000001111100110111111111111111111111111111111111111111111111111111111000111000000000
000111111111111111111111111111111101000001110000001111000000000000000001111100000111111111111111111111111111111111111111111111110000000011000000000000
001111111111111111111111111111110000000000000000000000000000000000110000011000011111111111111111111111111111111111111111111111100000000110000000000000
001111111000111111111111111111110000000111000000000000000000000000110000100001111111111111111111111111111111111111111111111111000000001110000000000000
000011100000001111111111111111110000000111101100000000000000000011011000100011111111111111111111111111111111111111111111111111000000001110000000000000
000000000000000011111111111111111000000011111100000000000000000011111011111111111111111111111111111111111111111111111111111111110000000000000000000000
000000000000000001111111111111111110000111111100000000000000000000000111111111111111111111111111111111111111111111111111111111110000000000000000000000
000000000000000001111111111111111111100111111111000000000000000000011111111111111111111111111111111111111111111111111111111111100000000000000000000000
000000000000000000111111111111111111111111111111000000000000000000001111111111111000011100011111111111111111111111111111111111100000000000000000000000
000000000000000000011111111111111111111111100001100000000000000000001110010111111000001100111111111111111111111111111111111110000000000000000000000000
000000000000000000011111111111111111111111111000100000000000000001111000011011110000001110011111111111111111111111111111111000000000000000000000000000
000000000000000000011111111111111111111111111000000000000000000001110000001101001111111110011111111111111111111111111100111000000000000000000000000000
000000000000000000011111111111111111111111000000000000000000000001100111101001101111111111011111111111111111111111111110001100000000000000000000000000
000000000000000000011111111111111111111110000000000000000000000000011111110000000001111111111111111111111111111111111110001100000000000000000000000000
000000000000000000001111111111111111111100000000000000000000000001111111110000000001111111111111111111111111111111111111000000000000000000000000000000
000000000000000000001111111111111111111100000000000000000000000011111111111111111101111111111111111111111111111111111111000000000000000000000000000000
000000000000000000000111111111111111111100000000000000000000000011111111111111111100111110011111111111111111111111111111000000000000000000000000000000
000000000000000000000011111111111111111000000000000000000000000111111111111111111110111111000000111111111111111111111110000000000000000000000000000000
000000000000000000000000111111110000110000000000000000000000011111111111111111111110011111111000001111111111111111111100000000000000000000000000000000
000000000000000000000000111111110000000000000000000000000000011111111111111111111111001111111000001111111000111111000000000000000000000000000000000000
000000000000000000000000011111100000000000000000000000000000001111111111111111111111101111111000000111110000111110000000000000000000000000000000000000
000000000000000000000000001111100000000000000000000000000000011111111111111111111111100111100000000111000000001011000000000000000000000000000000000000
000000000000000000000000000111100110000000000000000000000000011111111111111111111111110100000000000011000000000111100000000000000000000000000000000000
000000000000000000000000000011111110000000000000000000000000001111111111111111111111111011000000000001000000000011100000000000000000000000000000000000
000000000000000000000000000000101111100000000000000000000000000111111111111111111111111111000000000000100000000001100000000000000000000000000000000000
000000000000000000000000000000000001100000000000000000000000000011111111111111111111111111000000000000100000000001110000000000000000000000000000000000
000000000000000000000000000000000000110000000000000000000000000000000000011111111111111110000000000000000000000000110000000000000000000000000000000000
000000000000000000000000000000000000011000000000000000000000000000000000011111111111110000000000000000000000000000110000000000000000000000000000000000
000000000000000000000000000000000000001111000000000000000000000000000000011111111111110000000000000000000000000110010000000000011100000000000000000000
000000000000000000000000000000000000001111110000000000000000000000000000011111111111110000000000000000000000000011000000000000111100000000000000000000
000000000000000000000000000000000000011111111110000000000000000000000000001111111111100000000000000000000000000001000111111100111100000000000000000000
000000000000000000000000000000000000011111111111100000000000000000000000001111111111100000000000000000000000000001110011111100000000000000000000000000
000000000000000000000000000000000000111111111111110000000000000000000000001111111111110000000000000000000000000000110000000000000000000000000000000000
000000000000000000000000000000000000111111111111111000000000000000000000001111111111110001000000000000000000000000000000000000000000000000000000000000
000000000000000000000000000000000000111111111111111111100000000000000000001111111111100111000000000000000000000000000000000000000000000000000000000000
000000000000000000000000000000000000011111111111111111100000000000000000001111111111100110000000000000000000000000000000000000000110000000000000000000
000000000000000000000000000000000000011111111111111111000000000000000000001111111111000110000000000000000000000000000000000000101111001000000000000000
000000000000000000000000000000000000001111111111111111000000000000000000000111111110000110000000000000000000000000000000000001111111111100000000000000
000000000000000000000000000000000000000111111111111111000000000000000000000111111110000000000000000000000000000000000000000001111111111100000000000000
000000000000000000000000000000000000000011111111111110000000000000000000000111111100000000000000000000000000000000000000001111111111111110000000000000
000000000000000000000000000000000000000011111111111110000000000000000000000011111000000000000000000000000000000000000000011111111111111111000000000000
000000000000000000000000000000000000000011111111111100000000000000000000000011110000000000000000000000000000000000000000001111111111111111000000000000
000000000000000000000000000000000000000011111111111000000000000000000000000000000000000000000000000000000000000000000000001111111111111111000000000000
000000000000000000000000000000000000000011111111110000000000000000000000000000000000000000000000000000000000000000000000001111111111111111000000000000
000000000000000000000000000000000000000011111111100000000000000000000000000000000000000000000000000000000000000000000000001110000000111111000000110000
000000000000000000000000000000000000000011111110000000000000000000000000000000000000000000000000000000000000000000000000000000000000111110000000110000
000000000000000000000000000000000000000111111110000000000000000000000000000000000000000000000000000000000000000000000000000000000000011100000000000000
000000000000000000000000000000000000000111111100000000000000000000000000000000000000000000000000000000000000000000000000000000000000000000000000000000
000000000000000000000000000000000000000111110000000000000000000000000000000000000000000000000000000000000000000000000000000000000000000100000000100000
000000000000000000000000000000000000000111100000000000000000000000000000000000000000000000000000000000000000000000000000000000000000000000000001100000
000000000000000000000000000000000000000111000000000000000000000000000000000000000000000000000000000000000000000000000000000000000000000000000011100000
000000000000000000000000000000000000000111000000000000000000000000000000000000000000000000000000000000000000000000000000000000000000000000000111000000
000000000000000000000000000000000000000110000000000000000000000000000000000000000000000000000000000000000000000000000000000000000000000000000111000000
000000000000000000000000000000000000001110000000000000000000000000000000000000000000000000000000000000000000000000000000000000000000000000000000000000
000000000000000000000000000000000000001110000000000000000000000000000000000000000000000000000000000000000000000000000000000000000000000000000000000000
000000000000000000000000000000000000000110000000000000000000000000000000000000000000000000000000000000000000000000000000000000000000000000000000000000
000000000000000000000000000000000000000000000000000000000000000000000000000000000000000000000000000000000000000000000000000000000000000000000000000000
